###############################
###############################
###############################
###############################
###############################
###############################
m########g#####################
*******************************