b###############################b
b###############################b
b###cccccc########ccccccccc#####b
b##########k####################b
b##########b####################b
b########bbb####################b
bm######bbbb#########b#g#####f##b
b******************##***********b