###############################
###############################
###############################
##########g####################
##########b####################
########bbb####################
m######bbbb####################
*******************************